Detector,Profile,File,Threshold,Score,TP,TN,FP,FN,Total_Count
chebyshev,reward_low_FP_rate,realAWSCloudwatch/ec2_network_in_257a54.csv,0.5230443422260267,0.8571268814503882,2,3025,0,401,3428
chebyshev,reward_low_FP_rate,realAWSCloudwatch/ec2_cpu_utilization_ac20cd.csv,0.5230443422260267,-1.0,0,3025,0,403,3428
chebyshev,reward_low_FP_rate,realAWSCloudwatch/rds_cpu_utilization_e47b3b.csv,0.5230443422260267,-0.13844919792440225,2,3026,0,400,3428
chebyshev,reward_low_FP_rate,realAWSCloudwatch/iio_us-east-1_i-a2eb1cd9_NetworkIn.csv,0.5230443422260267,-2.0,0,931,0,126,1057
chebyshev,reward_low_FP_rate,realAWSCloudwatch/rds_cpu_utilization_cc0c53.csv,0.5230443422260267,-2.0,0,3026,0,402,3428
chebyshev,reward_low_FP_rate,realAWSCloudwatch/ec2_cpu_utilization_5f5533.csv,0.5230443422260267,-2.0,0,3026,0,402,3428
chebyshev,reward_low_FP_rate,realAWSCloudwatch/ec2_network_in_5abac7.csv,0.5230443422260267,-1.4856726008544074,8,3532,15,466,4021
chebyshev,reward_low_FP_rate,realAWSCloudwatch/ec2_cpu_utilization_c6585a.csv,0.5230443422260267,0.0,0,3428,0,0,3428
chebyshev,reward_low_FP_rate,realAWSCloudwatch/elb_request_count_8c0756.csv,0.5230443422260267,-2.0,0,3026,0,402,3428
chebyshev,reward_low_FP_rate,realAWSCloudwatch/ec2_disk_write_bytes_c0d644.csv,0.5230443422260267,-3.0,0,3023,0,405,3428
chebyshev,reward_low_FP_rate,realAWSCloudwatch/ec2_cpu_utilization_825cc2.csv,0.5230443422260267,-1.0,0,3085,0,343,3428
chebyshev,reward_low_FP_rate,realAWSCloudwatch/ec2_cpu_utilization_fe7f93.csv,0.5230443422260267,-3.0,0,3023,0,405,3428
chebyshev,reward_low_FP_rate,realAWSCloudwatch/grok_asg_anomaly.csv,0.5230443422260267,-3.0,0,3463,0,465,3928
chebyshev,reward_low_FP_rate,realAWSCloudwatch/ec2_cpu_utilization_24ae8d.csv,0.5230443422260267,-2.0,0,3026,0,402,3428
chebyshev,reward_low_FP_rate,realAWSCloudwatch/ec2_cpu_utilization_53ea38.csv,0.5230443422260267,-2.0,0,3026,0,402,3428
chebyshev,reward_low_FP_rate,realAWSCloudwatch/ec2_cpu_utilization_77c1ca.csv,0.5230443422260267,-1.0,0,3025,0,403,3428
chebyshev,reward_low_FP_rate,realAWSCloudwatch/ec2_disk_write_bytes_1ef3de.csv,0.5230443422260267,-1.6467804929974106,0,3545,3,473,4021
chebyshev,reward_low_FP_rate,realTraffic/TravelTime_387.csv,0.5230443422260267,-3.0,0,1876,0,249,2125
chebyshev,reward_low_FP_rate,realTraffic/occupancy_t4013.csv,0.5230443422260267,-2.0,0,1875,0,250,2125
chebyshev,reward_low_FP_rate,realTraffic/TravelTime_451.csv,0.5230443422260267,-1.0,0,1621,0,217,1838
chebyshev,reward_low_FP_rate,realTraffic/occupancy_6005.csv,0.5230443422260267,-1.0,0,1784,0,239,2023
chebyshev,reward_low_FP_rate,realTraffic/speed_t4013.csv,0.5230443422260267,-2.0,0,1871,0,250,2121
chebyshev,reward_low_FP_rate,realTraffic/speed_7578.csv,0.5230443422260267,-4.0,0,842,0,116,958
chebyshev,reward_low_FP_rate,realTraffic/speed_6005.csv,0.5230443422260267,-1.0,0,1886,0,239,2125
chebyshev,reward_low_FP_rate,artificialWithAnomaly/art_daily_jumpsdown.csv,0.5230443422260267,-1.0,0,3025,0,403,3428
chebyshev,reward_low_FP_rate,artificialWithAnomaly/art_daily_nojump.csv,0.5230443422260267,-1.0,0,3025,0,403,3428
chebyshev,reward_low_FP_rate,artificialWithAnomaly/art_load_balancer_spikes.csv,0.5230443422260267,-1.0,0,3025,0,403,3428
chebyshev,reward_low_FP_rate,artificialWithAnomaly/art_increase_spike_density.csv,0.5230443422260267,-1.0,0,3025,0,403,3428
chebyshev,reward_low_FP_rate,artificialWithAnomaly/art_daily_flatmiddle.csv,0.5230443422260267,-1.0,0,3025,0,403,3428
chebyshev,reward_low_FP_rate,artificialWithAnomaly/art_daily_jumpsup.csv,0.5230443422260267,-1.0,0,3025,0,403,3428
chebyshev,reward_low_FP_rate,realAdExchange/exchange-2_cpm_results.csv,0.5230443422260267,-2.0,0,1219,0,162,1381
chebyshev,reward_low_FP_rate,realAdExchange/exchange-4_cpm_results.csv,0.5230443422260267,-0.26352642487668243,2,1233,0,162,1397
chebyshev,reward_low_FP_rate,realAdExchange/exchange-3_cpm_results.csv,0.5230443422260267,-1.0,0,1155,0,153,1308
chebyshev,reward_low_FP_rate,realAdExchange/exchange-3_cpc_results.csv,0.5230443422260267,-3.0,0,1155,0,153,1308
chebyshev,reward_low_FP_rate,realAdExchange/exchange-4_cpc_results.csv,0.5230443422260267,0.7322576964241518,3,1232,0,162,1397
chebyshev,reward_low_FP_rate,realAdExchange/exchange-2_cpc_results.csv,0.5230443422260267,-1.0,0,1218,0,163,1381
chebyshev,reward_low_FP_rate,artificialNoAnomaly/art_noisy.csv,0.5230443422260267,0.0,0,3428,0,0,3428
chebyshev,reward_low_FP_rate,artificialNoAnomaly/art_daily_small_noise.csv,0.5230443422260267,0.0,0,3428,0,0,3428
chebyshev,reward_low_FP_rate,artificialNoAnomaly/art_daily_perfect_square_wave.csv,0.5230443422260267,0.0,0,3428,0,0,3428
chebyshev,reward_low_FP_rate,artificialNoAnomaly/art_flatline.csv,0.5230443422260267,0.0,0,3428,0,0,3428
chebyshev,reward_low_FP_rate,artificialNoAnomaly/art_daily_no_noise.csv,0.5230443422260267,0.0,0,3428,0,0,3428
chebyshev,reward_low_FP_rate,realTweets/Twitter_volume_GOOG.csv,0.5230443422260267,-3.0,0,13660,0,1432,15092
chebyshev,reward_low_FP_rate,realTweets/Twitter_volume_KO.csv,0.5230443422260267,0.7209256359491047,2,13514,0,1585,15101
chebyshev,reward_low_FP_rate,realTweets/Twitter_volume_UPS.csv,0.5230443422260267,-3.139090436467977,4,13531,0,1581,15116
chebyshev,reward_low_FP_rate,realTweets/Twitter_volume_AAPL.csv,0.5230443422260267,0.37811445423188017,11,13558,6,1577,15152
chebyshev,reward_low_FP_rate,realTweets/Twitter_volume_CRM.csv,0.5230443422260267,-1.1395397014711486,3,13559,0,1590,15152
chebyshev,reward_low_FP_rate,realTweets/Twitter_volume_AMZN.csv,0.5230443422260267,-2.1393104157794056,1,13501,0,1579,15081
chebyshev,reward_low_FP_rate,realTweets/Twitter_volume_PFE.csv,0.5230443422260267,-4.0,0,13520,0,1588,15108
chebyshev,reward_low_FP_rate,realTweets/Twitter_volume_CVS.csv,0.5230443422260267,0.4934316689547944,2,13577,0,1524,15103
chebyshev,reward_low_FP_rate,realTweets/Twitter_volume_FB.csv,0.5230443422260267,-0.13975888913829626,1,13501,0,1581,15083
chebyshev,reward_low_FP_rate,realTweets/Twitter_volume_IBM.csv,0.5230443422260267,-2.0,0,13553,0,1590,15143
chebyshev,reward_low_FP_rate,realKnownCause/rogue_agent_key_hold.csv,0.5230443422260267,-2.0,0,1410,0,190,1600
chebyshev,reward_low_FP_rate,realKnownCause/cpu_utilization_asg_misconfiguration.csv,0.5230443422260267,-1.0,0,15801,0,1499,17300
chebyshev,reward_low_FP_rate,realKnownCause/nyc_taxi.csv,0.5230443422260267,-5.0,0,8535,0,1035,9570
chebyshev,reward_low_FP_rate,realKnownCause/rogue_agent_key_updown.csv,0.5230443422260267,-1.5148083230975047,1,4030,5,529,4565
chebyshev,reward_low_FP_rate,realKnownCause/ambient_temperature_system_failure.csv,0.5230443422260267,-2.0,0,5791,0,726,6517
chebyshev,reward_low_FP_rate,realKnownCause/ec2_request_latency_system_failure.csv,0.5230443422260267,-3.0,0,3082,0,346,3428
chebyshev,reward_low_FP_rate,realKnownCause/machine_temperature_system_failure.csv,0.5230443422260267,-4.0,0,19677,0,2268,21945
Totals,,,,-85.42508014559692,42,299318,29,33453,332842
